NO textures/north_texture.xpm
SO textures/south_texture.xpm
WE textures/west_texture.xpm
EA textures/east_texture.xpm

F 113,113,113
C 51,198,117


1111111111
1000000001
1111000001
1000000001
100N001001
1010001011
100000100111111111
111111110100000001
      100000000001
      100000000001
      100001110111
      100001100001
      100001000001
      111111111101