NO textures/north_texture.xpm
SO textures/south_texture.xpm
WE textures/west_texture.xpm
EA textures/east_texture.xpm

F 113,113,113
C 51,198,117


 1 1  1 1  1 1 1 0 0  1 0 1 0 1 0 1 0
 100000011
1111111111110000001
10000000S1
1000010001
1010001011
1000001001
1111100001
    111111