NO ./path_to_the_north_texture
SO ./path_to_the_south_texture
WE ./path_to_the_west_texture
EA ./path_to_the_east_texture

F 220,100,0
C 225,30,0

111111111111111
100000000000001
100011111100001
111000100001001
1111N0100000001
110000011111101
111111111111111
